##################################
#               .               .#
# ######## #################### ##
#     .                .         #
# ##     ##### # ##.         ##.##
# .#     ###.  # .#    ##    ##.##
#    .                  .     #.##
# .                .             #
##################################